11111111111111111111                       
121            3 141                            
1 1            1 1 1                            
1 1            1 1 1                            
131            1 131                            
131            1 1 1                            
131            131 1                            
1              131 1                            
1111111111111111 1 1                            
1                1 1                            
131111111111111111 1                            
1                1 1                            
111111111111111131 1                            
1                131                            
131111111111111111 1                            
1                  1   
1                  1                 
1                  1                 
1                  1                                          
11111111111111111111