11111111111111111111 
121 3 1 3 1 3 1 3311
1 1 1 1 1 1 1 1 1  1
1 1 1 1 1 1 1 1 1  1
1 1 1 1 1 1 1 1 1  1
1 1 1 1 1 1 1 1 1  1
1 1 1 1 1 1 1 1 1  1
1 1 1 1 1 1 1 1 1  1
1 1 1 1 1 1 1 1 1  1
1 1 1 1 1 1 1 1 1  1
1 1 1 1 1 1 1 1 1  1
1 1 1 1 1 1 1 1 1  1
1 1 1 1 1 1 1 1 1  1
1 1 1 1 1 1 1 1 1  1
1 1 1 1 1 1 1 1 1  1
1 1 1 1 1 1 1 1 1  1
1 1 1 1 1 1 1 1 1  1
1 1 1 1 1 1 1 1 1311
1 3 1 3 1 3 1 3 1 41
11111111111111111111