11111111111111111111 
121   1 3 1   1    1 
1 1 1   1   1 1 1  1 
1 1 11111111  1 1  1 
1 1     3  1 11 1  1 
1311111111 13 1 1  1 
1       3  11 1 1  1 
111111111111  1 1  1 
1 3           131  1 
1 111111111111131  1 
1 111111111111131  1 
1 3             1  1 
11111111111111111  1 
1                  1 
1                  1 
1                  1 
1                  1 
1                  1 
14                 1 
11111111111111111111 